!Test Level;30;17;Tileset1
-
282828282828282828282828282828282828282828282828282828282828
292929292929292929292929292929292929292929292929292929292929
303030303030303030303030303030303030303030303030303030303030
010101010101010101010101010101010101010101010101010101010101
010101010101010101010101010101010101010101010101010101010101
010101010101010101010101010101010101010101010101010101010101
010101010101010101010101010101010101010101010101010101010101
010101010101010101010101010101010101010101010101010101010101
010101010101010101010101010101010101010101010101010101010101
010101010101010101010101010101010101010101010101010101010101
010101010101010101010101010101010101010101010101010101010101
010101010101010101010101010101010101010101010101010101010101
010101010101010101010101010101010101010101010101010101010101
010101010101010101010101010101010101010101010101010101010101
010101010101010101010101010101010101010101010101010101010101
010101010101010101010101010101010101010101010101010101010101
010101010101010101010101010101010101010101010101010101010101
-
310031003100310031003100310031003100310031003100310031003100
003200320032003200320032003200320032003200320032003200320032
000000000000000000000000000000000000000000000000000000000000
000000000000000000000000000000000000000000000000000000000000
000000000000000000000000000000000000000000000000000000000000
000000000000000000000000000000000000000000000000000000000000
000000000000000000000000000000000000000000000000000000000000
000000000000000000000000000000000000000000000000000000000000
000000000000000000000000000000000000000000000000000000000000
000000000000000000000000000000000000000000000000000000000000
000000000000000000000000000000000000000000000000000000000000
000000000000000000000000000000000000000000000000000000000000
000000000000000000000000000000000000000000000000000000000000
000000000000000000000000000000000000000000000000000000000000
000000000000000000000000000000000000000000000000000000000000
000000000000000000000000000000000000000000000000000000000000
222222232222222322222223222222232222222322222223222222232222
